C 255,255,255
R 1920 1080
F 255,115,115

S  ./textures/test-sprite.xpm
SO ./textures/mur-1.xpm
NO ./textures/mur-3.xpm
EA ./textures/mur-2.xpm
WE ./textures/mur-4.xpm


111111111111111111111111111111
111111110000200000000000011111
100000000000000111110001000001
110000100000000000000000011111
10000111111100000S000001111111
111111100000000000000000000001
111100000000000110000002000011
110000000000001111000000000011
100000000000011100000000000011
11000000000001110000000000111100
110000000000111100000000000111
11111111111111111111111111111111
